4 4 4 4 4 4 4 4 4 4 4 4 4 4 4 4 4 4 4 4 4 4 4 4 4 4 4 4 4 4 4 4 4 4 4 4 4 4 4 4 4 4 4 4 4 4 4 4
4 4 4 4 4 4 4 4 4 4 4 4 4 4 4 4 4 4 4 4 4 4 4 4 4 4 4 4 4 4 4 4 4 4 4 4 4 4 4 4 4 4 4 4 4 4 4 4
4 4 4 4 4 4 4 0 4 4 4 4 4 4 4 4 4 4 4 4 4 4 4 4 4 4 4 4 4 4 4 4 4 4 4 4 4 4 4 4 4 4 4 4 4 4 4 4
4 4 4 0 4 4 4 4 4 0 4 4 4 6 4 4 4 4 0 4 4 4 4 4 4 4 4 4 4 4 4 4 4 4 4 4 4 4 4 4 4 4 4 4 4 4 4 4
4 4 4 4 4 4 5 4 4 4 4 1 3 3 3 2 4 4 4 4 4 4 4 4 4 4 4 4 4 4 4 0 4 4 4 4 4 4 4 4 0 4 4 4 4 1 3 3
3 3 3 4 4 1 3 2 4 4 4 0 0 0 0 0 4 4 4 4 4 4 5 4 4 6 4 4 4 4 6 4 4 5 4 6 4 4 0 4 4 4 4 0 4 0 0 0
0 0 0 4 4 0 0 0 4 4 4 0 0 0 0 0 4 4 4 4 1 3 3 3 3 3 2 4 4 1 3 3 3 3 3 3 2 4 4 4 4 4 4 4 4 0 0 0
0 0 0 4 4 0 0 0 4 4 4 0 0 0 0 0 4 4 4 4 0 0 0 0 0 0 0 4 4 0 0 0 0 0 0 0 0 4 4 4 4 4 4 4 4 0 0 0
0 0 0 4 4 0 0 0 4 4 4 0 0 0 0 0 4 4 4 4 0 0 0 0 0 0 0 4 4 0 0 0 0 0 0 0 0 4 4 4 4 4 4 4 4 0 0 0